8 8
########
#a....a#
#.A....#
#......#
#......#
#....A.#
#@....a#
########
