10 12
############
#......a...#
#..........#
#...a...A..#
#...###.A..#
#......#@A.#
#..........#
#.........a#
#..........#
############
