8 8
########
#.....a#
#.A....#
#......#
#......#
#....A.#
#@.....#
########
